# コメント済みは微妙なもの
# 品詞は未設定
あんしょうぶん	暗証文	名詞	パスフレーズ
ぶろくさ	部録鎖	名詞	ブロックチェーン
えっちそうふ	越地走譜	名詞	クロスサイトスクリプティング
だいこうしゃわりこみこうげぎ	代行者割り込み攻撃	名詞	
わりこみだいこうこうげぎ	割込代行攻撃	名詞	
わりこみこうげぎ	割込攻撃	名詞	
こうにんかぎ	公認鍵	名詞	public endorsement key
えんめいきゅうでんそうち	延命給電装置	名詞	無停電電源装置
てんこ	天呼	名詞	システムコール
もじきゅう	文字級	名詞	フォントサイズ
じたけ	字丈	名詞	フォントサイズ
いたい	伊体	名詞	イタリック
ふたい	譜体	名詞	ソフトウエア
#あくたい	悪体	名詞	マルウェア
#とうたい	盗体	名詞	スパイウェア
#こうこくたい	広告体	名詞	アドウェア
ゆうそうてき	優操的	名詞	アクセシブル
ゆうそうせい	優操性	名詞	アクセシビリティ
かんけいだいちょう	関係台帳	名詞	リレーショナルデータベース
かんけいだいちょうかんりけい	関係台帳管理系	名詞	リレーショナルデータベースマネジメントシステム
かいいんこうざ	会員口座	名詞	ユーザーアカウント
えんふたく	演譜卓	名詞	コンソール
えんたく	演卓	名詞	コンソール
だいふ	台譜	名詞	スクリプト
しぇる	司得	名詞	シェル
#ばっしゅ	抜首	名詞	bash
ばっしゅ	発修	名詞	bash
ぜっと	絶砥	名詞	Z
ぜっとしぇる	絶砥司得	名詞	zsh

よいき	余域	名詞	codomain
かんしゅ	関手	名詞	functor
にこうかんしゅ	二項関手	名詞	bifunctor
ふぁんくた	関手	名詞	functor
しぜんへんかん	自然変換	名詞	natural transformation	
きょうへんかんしゅ	共変関手	名詞	covariant functor
はんぺんかんしゅ	反変関手	名詞	contravariant functor
でかるとへいけん	デカルト閉圏	名詞	Cartesian Closed Category
ものいど	モノイド	名詞	monoid
よものいど	余モノイド	名詞	comonoid
そうものいど	双モノイド	名詞	bimonoid
そうけん	双圏	名詞	bicategory
にじゅうけん	二重圏	名詞	double category
よだいすう	余代数	名詞	coalgebra
そうだいすう	双代数	名詞	bialgebra
かぐん	加群	名詞	module
よかぐん	余加群	名詞	comodule
そうかぐん	双加群	名詞	bimodule
もなど	モナド	名詞	monad

もくよう	黙用	名詞	デフォルト
もくようち	黙用値	名詞	デフォルト値
じき	時記	名詞	ログ

せいしょき	清書器	名詞	プリプロセサ
くみと	組詞	名詞	アセンブリ
くみたてき	組立器	名詞	アセンブラ
りんく	結合	名詞	
けつごうき	結合器	名詞	リンカー
りんかー	結合器	名詞	
はいか	配荷	名詞	
はいかき	配荷器	名詞	ローダー
ろーだー	配荷器	名詞	


さんふ	算譜	名詞	さんぷ
ふたい	譜体	名詞	プログラム
えんふ	演譜	名詞	プログラミング
げんふ	原譜	名詞	ソース
せいふ	製譜	名詞	コンパイル
せいふき	製譜器	名詞	コンパイラー
さんけい	算系	名詞	システム
きほんさんけい	基本算系	名詞	OS
さんけいえんふ	算系演譜	名詞	システムプログラミング
さんけいえんふげんご	算系演譜言語	名詞	システムプログラミング言語
ごみしゅうしゅうぶ	ごみ収集部	名詞	ガベージコレクター
ききくどうしょ	機器駆動書	名詞	デバイスドライバー
ばさし	場指し	名詞	ポインター
がいきのうないつう	外機能内通	名詞	外部関数インターフェース
がいつう	外通	名詞	
がいきのう	外機能	名詞	
さまあわせ	様合わせ	名詞	パターン照合
#		名詞	
そくのうしけん	測能試験	名詞	ベンチマークテスト
#		名詞	
ていふくがた	定幅型	名詞	
へんぷくがた	変幅型	名詞	
#		名詞	
ほうりゅうろせん	放流路線	名詞	

# 特殊系
こ	余	接頭辞	co
ばい	双	接頭辞	bi
